000000000000000000000000000000000000000000000000000000000000
144114444440000000000000000000000000000000000000000000000000
222222222240000000000000000000000000000000000000000000000000
222224422244444444444440000000000000000000000000000000000000
333333322333333311111140000000000000000000000000000000000000
333122222211111331111140000000000000000000000000000000000000
331123333211111133311140000000000000000000000000000000000000
311123443211111111311140000000000000000000000000000000000000
111123443211111111331140000000000000000000000000000000000000
111123333211111111133340000000000000000000000000000000000000
111122222211111111111340000000000000000000000000000000000000
111111111111111111111340000000000000000000000000000000000000
444444444442224444444340000000000000000000000000000000000000
000000000000000000000300000000000000000000000000000000000000
000000000000000000000300000000000000000000000000000000000000
000000000000000000000000000000000000000000000000000000000000
000000000000000000000000000000000000000000000000000000000000
000000000000000000000000000000000000000000000000000000000000
000000000000000000000000000000000000000000000000000000000000
000000000000000000000000000000000000000000000000000000000000
000000000000000000000000000000000000000000000000000000000000
000000000000000000000000000000000000000000000000000000000000
000000000000000000000000000000000000000000000000000000000000
000000000000000000000000000000000000000000000000000000000000
000000000000000000000000000000000000000000000000000000000000
000000000000000000000000000000000000000000000000000000000000
000000000000000000000000000000000000000000000000000000000000
000000000000000000000000000000000000000000000000000000000000
000000000000000000000000000000000000000000000000000000000000
000000000000000000000000000000000000000000000000000000000000
000000000000000000000000000000000000000000000000000000000000
000000000000000000000000000000000000000000000000000000000000
000000000000000000000000000000000000000000000000000000000000
000000000000000000000000000000000000000000000000000000000000
000000000000000000000000000000000000000000000000000000120000
000000000000000000000000000000000000000000000000000000312000
000000000000000000000000000000000000000000000000000000031200
000000000000000000000000000000000000000000000000000000003120
000000000000000000000000000000000000000000000000000000000312
000000000000000000000000000000000000000000000000000000000031
------------------------------------------------------------
000000000000000000000000000000000000000000000000000000000000
011001111110000000000000000000000000000000000000000000000000
000000000010000000000000000000000000000000000000000000000000
000001100011111111111110000000000000000000000000000000000000
222222200222222200000010000000000000000000000000000000000000
222000000000000220000010000000000000000000000000000000000000
220002222000000022200010000000000000000000000000000000000000
200002112000000000200010000000000000000000000000000000000000
000002112000000000220010000000000000000000000000000000000000
000002222000000000022210000000000000000000000000000000000000
000000000000000000000210000000000000000000000000000000000000
000000000000000000000210000000000000000000000000000000000000
111111111110001111111210000000000000000000000000000000000000
000000000000000000000200000000000000000000000000000000000000
000000000000000000000200000000000000000000000000000000000000
000000000000000000000000000000000000000000000000000000000000
000000000000000000000000000000000000000000000000000000000000
000000000000000000000000000000000000000000000000000000000000
000000000000000000000000000000000000000000000000000000000000
000000000000000000000000000000000000000000000000000000000000
000000000000000000000000000000000000000000000000000000000000
000000000000000000000000000000000000000000000000000000000000
000000000000000000000000000000000000000000000000000000000000
000000000000000000000000000000000000000000000000000000000000
000000000000000000000000000000000000000000000000000000000000
000000000000000000000000000000000000000000000000000000000000
000000000000000000000000000000000000000000000000000000000000
000000000000000000000000000000000000000000000000000000000000
000000000000000000000000000000000000000000000000000000000000
000000000000000000000000000000000000000000000000000000000000
000000000000000000000000000000000000000000000000000000000000
000000000000000000000000000000000000000000000000000000000000
000000000000000000000000000000000000000000000000000000000000
000000000000000000000000000000000000000000000000000000000000
000000000000000000000000000000000000000000000000000000000000
000000000000000000000000000000000000000000000000000000000000
000000000000000000000000000000000000000000000000000000000000
000000000000000000000000000000000000000000000000000000000000
000000000000000000000000000000000000000000000000000000000000
000000000000000000000000000000000000000000000000000000000000
